F B B B B B B B B B B B B B B B B X B B 
F B B X B B B X B B B B X B X X B B B X 
F B B B X X B B X B B B B B X X B X X B 
B B B X X B X B B B X X X X B X X X B B 
B X B B B X B X X X X X B X X X X B X X 
B B X B B X X X X X X X X X X X B X X X 
X B X X B X X X X X X X X X X X X B X B 
B B X B X X X X X X X X X X X X X X X X 
X X X X X X X X X X X X X X X X B X X X 
B B B X X X X X X X X X X X X X X X X X 
X X X X X X X X X X X X X X X X B X X X 
X X X X X X X X X X X X X X X X X X B X 
X X X X X X X X X X X X X X X X X X B B 
B B X X X X X X X X X X X X X X X X X B 
B X X X X X X X X X X X X X X X X X X B 
X X X X X X X X X X X X X X X X X B X X 
X B X X X X X X X X X X X X X X X X B B 
X B X X X X X X X X X X X X X X X X X X 
B B B X X B B X X X X X X X X X X X B B 
B X B X X X X X X X X B X X X X B X X B 
