F F F F F F F F F F F F F F F F F F F F 
F F F F F F F F F F F F F F F F F F F F 
F F F F F F F F F F F F F F F F F F F F 
F F F F F F F F F F F F F F F F F F F F 
F F F F F F F F F F F F F F F F F F F F 
F F F F F F F F F F F F F F F F F F F F 
F F F F F F F F F F F F F F F F F F F F 
F F F F F F B F F F B B B F F F F F F F 
F F F F F F F B F B B B B B B F F F F F 
F F F F F B B B B B B B B B B F F F F F 
F F F F F B B B B B X B B B B F F F F F 
F F F F F B B B B X X X B F F F F F F F 
F F F F B B B B B X B B B B F F F F F F 
F F F F B B B B X X B B B B F F F F F F 
F F F F F B B B B B B B B B B F F F F F 
F F F F F B B B B B B B B B B F F F F F 
F F F F F F B F F B B B B B F F F F F F 
F F F F F F F F F F F F F B F F F F F F 
F F F F F F F F F F F F F F F F F F F F 
F F F F F F F F F F F F F F F F F F F F 
